11111111111111111111111111111111111111111111111111
11111111101010101010111111101110101010101011101111
10001000000000000000000000101000001000000000101011
11101111101010111111111110111111101110111111101011
10100010101010100000000000100010000000001010001001
10111010111111111010111110111011111110111010111011
10000000000000001010100000000010001010101000001011
10101111111111101111111010111011101010101011111011
10101000000000000010100010100000000000000000001001
11111110111110111010111111111011111011101111111111
10100000100000100000101010000010000010000000101011
10111011111010111110101011101011101111101111101011
100000100000101000000000000010001010000c0000000001
11101011101010101111101110101011111010101010111011
10001010001010101000001000101000100010101010001011
10111111111110111110101010101111111011101010111111
10101010000000100000101010100010000010001010000001
11101011111011111111101111101111101011101110101011
10100010001010000000001000001000001010000010101011
10111011101111111110111110101110101m11101111101111
10100010101010100000100000101000100010001000000011
10111010101010111111111010101011101111111110101011
10000000000000000000000010101010001000000000101011
10111110101010111010101011101111101110101110111111
10100000101010100010101010001000000010101000001011
10101110111010101010111110111110101111111110111011
10101000100010101010100000100000101010000000000001
11111110111010101111111010101010111011111010101011
10000000001010101000000010101010100000000010101011
10111110101111111111111010101110101111101011101011
10100000100010000000000010101000101000001000101011
10101110101111111111101010111110111110101011101111
10101000101010101010001010100010100000101010000001
10111110111010101011101010111011111110101011101011
10100000100000000000001010100000000000101010001011
11111110111011111011101110101011111110111111111011
10000000100010000010000010101010000000000010000001
11111011111011101010101110111110111010101011111011
10000010000000101010100010100000100010101010000001
11111111101011111110101110111111111010101011111011
10000000001000001000100010100000000010101010000001
11101010101010101111101111111011111010101011101011
10001010101010101000001000000010000010101010001011
10101110101010111111101110101010101010111110101111
10101000101010101010001000101010101010001000100011
11111110111011101011101110111110111010101110101011
10100000001010000000001000001000001010101000101001
10111110111011101010101110111010111011101111111011
10000000001010001010101000001010100010000010000001
11111111111111111111111111111111111111111111111111